AJRouter	Stopped
ALG	Stopped
AppIDSvc	Stopped
Appinfo	Running
AppMgmt	Stopped
AppReadiness	Stopped
AppVClient	Stopped
AppXSvc	Stopped
AssignedAccessManagerSvc	Stopped
AudioEndpointBuilder	Running
Audiosrv	Running
autotimesvc	Stopped
AxInstSV	Stopped
BDESVC	Stopped
BFE	Running
BITS	Stopped
BrokerInfrastructure	Running
BTAGService	Running
BthAvctpSvc	Running
bthserv	Running
camsvc	Running
CDPSvc	Running
CertPropSvc	Stopped
ClickToRunSvc	Running
ClipSVC	Stopped
cloudidsvc	Stopped
COMSysApp	Stopped
CoreMessagingRegistrar	Running
CryptSvc	Running
CscService	Stopped
DcomLaunch	Running
dcsvc	Stopped
defragsvc	Stopped
DeviceAssociationService	Running
DeviceInstall	Stopped
DevQueryBroker	Running
Dhcp	Running
diagnosticshub.standardcollector.service	Stopped
diagsvc	Stopped
DiagTrack	Running
DialogBlockingService	Stopped
DispBrokerDesktopSvc	Running
DisplayEnhancementService	Running
DmEnrollmentSvc	Stopped
dmwappushservice	Stopped
Dnscache	Running
DolbyDAXAPI	Running
DoSvc	Running
dot3svc	Stopped
DPS	Running
dptftcs	Running
DSAService	Running
DSAUpdateService	Running
DsmSvc	Stopped
DsSvc	Running
DusmSvc	Running
EapHost	Stopped
edgeupdate	Stopped
edgeupdatem	Stopped
EFS	Running
embeddedmode	Stopped
EntAppSvc	Stopped
ET05A1EvtSvc	Stopped
EventLog	Running
EventSystem	Running
fdPHost	Stopped
FDResPub	Stopped
fhsvc	Stopped
FontCache	Running
FontCache3.0.0.0	Stopped
FrameServer	Stopped
FrameServerMonitor	Stopped
GameInputSvc	Stopped
GoogleChromeElevationService	Stopped
GoogleUpdaterInternalService130.0.6679.0	Stopped
GoogleUpdaterService130.0.6679.0	Stopped
gpsvc	Running
GraphicsPerfSvc	Stopped
hidserv	Running
HncUpdateService_2020	Running
hns	Running
HvHost	Stopped
icssvc	Running
IDBWM	Running
igccservice	Running
IKEEXT	Stopped
IMGSF50_Svc	Running
InstallService	Running
Intel Analytics Service	Running
Intel Connectivity Network Service	Running
Intel Provider Data Helper Service	Stopped
Intel(R) Platform License Manager Service	Stopped
IntelArcControlService	Running
IntelAudioService	Running
IntelConnectService	Running
InventorySvc	Running
ipfsvc	Running
iphlpsvc	Running
IpxlatCfgSvc	Stopped
KeyIso	Running
KtmRm	Stopped
LanmanServer	Running
LanmanWorkstation	Running
lfsvc	Running
LicenseManager	Running
lltdsvc	Stopped
lmhosts	Stopped
LSM	Running
LxpSvc	Stopped
MapsBroker	Stopped
MaximAudioService	Running
McpManagementService	Stopped
MDCoreSvc	Running
MicrosoftEdgeElevationService	Stopped
MixedRealityOpenXRSvc	Stopped
mpssvc	Running
MSDTC	Stopped
MSiSCSI	Stopped
msiserver	Stopped
MsKeyboardFilter	Stopped
NaturalAuthentication	Stopped
NaverWhaleElevationService	Stopped
NcaSvc	Stopped
NcbService	Running
NcdAutoSetup	Stopped
Netlogon	Stopped
Netman	Running
netprofm	Running
NetSetupSvc	Stopped
NetTcpPortSharing	Stopped
NgcCtnrSvc	Running
NgcSvc	Running
NlaSvc	Stopped
nsi	Running
nvagent	Running
OffloadItemService	Running
p2pimsvc	Stopped
p2psvc	Stopped
PcaSvc	Running
PeerDistSvc	Stopped
perceptionsimulation	Stopped
PerfHost	Stopped
PhoneSvc	Stopped
pla	Stopped
PlugPlay	Running
PNRPAutoReg	Stopped
PNRPsvc	Stopped
PolicyAgent	Stopped
Power	Running
PrintNotify	Stopped
ProfSvc	Running
PushToInstall	Stopped
QWAVE	Running
RasAuto	Stopped
RasMan	Running
RemoteAccess	Stopped
RemoteRegistry	Stopped
RetailDemo	Stopped
RmSvc	Running
RpcEptMapper	Running
RpcLocator	Stopped
RpcSs	Running
RtkAudioUniversalService	Running
SamSs	Running
Samsung Multi Control Service	Running
Samsung WiFi UHB Setting Service	Running
SamsungAccountService	Running
SamsungSystemSupportService	Running
SamsungUpdateService	Running
SCardSvr	Stopped
ScDeviceEnum	Stopped
Schedule	Running
SCPolicySvc	Stopped
SDRSVC	Stopped
seclogon	Running
SecurityHealthService	Running
SEMgrSvc	Stopped
SENS	Running
Sense	Stopped
SensorDataService	Stopped
SensorService	Stopped
SensrSvc	Stopped
SessionEnv	Stopped
SgrmBroker	Stopped
SharedAccess	Running
SharedRealitySvc	Stopped
ShellHWDetection	Running
shpamsvc	Stopped
smphost	Stopped
SmsRouter	Stopped
SNMPTrap	Stopped
spectrum	Stopped
Spooler	Running
sppsvc	Stopped
SSDPSRV	Running
ssh-agent	Stopped
SstpSvc	Running
StateRepository	Running
StiSvc	Running
StorSvc	Running
svsvc	Stopped
swprv	Stopped
SysMain	Running
SystemEventsBroker	Running
TapiSrv	Running
TermService	Stopped
TextInputManagementService	Running
Themes	Running
TieringEngineService	Stopped
TimeBrokerSvc	Running
TokenBroker	Running
TrkWks	Running
TroubleshootingSvc	Stopped
TrustedInstaller	Stopped
tzautoupdate	Stopped
UevAgentService	Stopped
uhssvc	Stopped
UmRdpService	Stopped
upnphost	Stopped
UserManager	Running
UsoSvc	Running
VacSvc	Stopped
VaultSvc	Running
VBoxSDS	Stopped
vds	Stopped
VMAuthdService	Running
vmcompute	Running
vmicguestinterface	Stopped
vmicheartbeat	Stopped
vmickvpexchange	Stopped
vmicrdv	Stopped
vmicshutdown	Stopped
vmictimesync	Stopped
vmicvmsession	Stopped
vmicvss	Stopped
VMnetDHCP	Running
VMUSBArbService	Running
VMware NAT Service	Running
VmwareAutostartService	Stopped
VSInstallerElevationService	Stopped
VSS	Stopped
VSStandardCollectorService150	Running
W32Time	Stopped
WaaSMedicSvc	Stopped
WalletService	Stopped
WarpJITSvc	Stopped
wbengine	Stopped
WbioSrvc	Stopped
Wcmsvc	Running
wcncsvc	Running
WdiServiceHost	Stopped
WdiSystemHost	Stopped
WdNisSvc	Running
WebClient	Stopped
webthreatdefsvc	Stopped
Wecsvc	Stopped
WEPHOSTSVC	Stopped
wercplsupport	Stopped
WerSvc	Stopped
WFDSConMgrSvc	Stopped
WiaRpc	Stopped
WinDefend	Running
WinHttpAutoProxySvc	Running
Winmgmt	Running
WinRM	Stopped
wisvc	Stopped
WlanSvc	Running
wlidsvc	Stopped
wlpasvc	Stopped
WManSvc	Stopped
wmiApSrv	Stopped
WMIRegistrationService	Running
WMPNetworkSvc	Stopped
workfolderssvc	Stopped
WpcMonSvc	Running
WPDBusEnum	Stopped
WpnService	Running
wscsvc	Running
WSearch	Running
WslInstaller	Stopped
WSLService	Running
wuauserv	Stopped
wusvcm	Stopped
WwanSvc	Stopped
XblAuthManager	Stopped
XblGameSave	Stopped
XboxGipSvc	Stopped
XboxNetApiSvc	Stopped
